1111111111111111111111
1010001111101110101111
1010101111111111111011
1000000P000000V0001111
1011101011101010111011
1111111011000100010111
1000111000001010111011
1010101011100001001011
1110111010001000H00011
1000C00C101010000000E1
1111111111111111111111