111111111111111111111
100001100011000000001
100010010100100000001
1E010000100001000P001
100100000000010000001
100010000C000000C0001
100001000001000000001
100000100010000000001
1C00000001000000000C1
100000001000000000011
111111111111111111111