11111111111
1P0C1C111C1
11101000001
1C0011101C1
101000C0101
10111111101
10100C10001
10C01E11C11
11111111111